9999999999999999999999999999999999999999x
           CCCCC          CCCCC         x
SSSSSSSSSSSSSSSSSSSSSSSSSSSSSSSSSSSSSSSSx
                                        x
CCCCCCCCCCCCCCCCCCCCCCCCCCCCCCCCCCCCCCCCx
     WZ                            ZW   x
                   YY                   x
          JJ       SS       JJ          x
                                        x
JJCCCCCCCC                    CCCCCCCCJJx
  SSSSSSSS                    SSSSSSSS  x
                                        x
              S  i       S              x
              SSSSSSSSSSSS              x
                                        x
  M                                  L  x
         SSS                SSS         x
  S                                  S  x
          Z                  Z          x
                                        x
          i                 i           x
      SSSSSSSSS          SSSSSSSSS      x
                                        x
FFFFFFFFFFFFFFFFFFFFFFFFFFFFFFFFFFFFFFFFx
